R  640 480
NO ./texture/north.xpm
SO ./texture/south.xpm
WE ./texture/west.xpm
EA ./texture/east.xpm

S ./texture/pillar.xpm
F 255,60,60
C 200,60,10

111111111111111111111111111111111
100000000011000000000000111111111
101100000111000000000000111111111
100100000000000000000001111111111
11110N011011000001110000000000001
100000000011000001110111111111111
111101111111100110000001000111111
11110111111110001101010010001
11111111111111110000001000111
1000001000000010000000000001
1000000000000010000000000001
1000000000000010000001000111
1100000000000110101001000111
1000000000000010101111111011
11111111111111101111010001111
111111111111111111111111111111
