R 1920                100000
NO ./path_to_the_north_texture
SO ./path_to_the_south_texture
WE ./path_to_the_west_texture
EA ./path_to_the_east_texture

S ./path_to_the_sprite_texture
F 255,5,5,6
C 200,60,10

11111111111111111
1110100001N11110011111011
111000001N111100111111101
11111111111111111111111