R 1200 800
WE ./texture/west.xpm
NO ./texture/north.xpm
S ./texture/pillar.xpm
SO ./texture/south .xpm
EA ./texture/east.xpm

C 25,0,255
F 255,255,0
            11111111111111111111111111
1111111111111111100000011
1011000001110000000000001
10010000000000000000000011111111111
111111111011000001110000000000001111
10010000000000000000000011111111111
10000000001100000111011111111111111
11111111100000001000111111111111111111
        111100000000000011101010010011111111
        1111111110000000000000000111111111
1111111111110000000000000020000001111111111111
10000000000000000000000000000000000001110111111111111
1111111111000200000000000000000001111111111111111111111111111111111
        1011111112002000000011111111111
111111111100000000000010100111111111111111111111111
11111111110000000000000000000000000000000001010111000000111111111111111
11000000000000000000W00000001111000000000000000110000010001111
11000000000000000000000000200000000001000111111111111111111111
110000000001010111110111100111111111111111111
11111111111101011101111010001111
1111111111111111111111111111111