R  640 480
NO ./texture/north.xpm
SO ./texture/south.xpm
WE ./texture/west.xpm
EA ./texture/east.xpm

S ./texture/pillar.xpm

F 255,60,60
C 200,60,10

1111111111111111111111111
1000000000110000000000001
1011000001110000200000001
100100000000000000000000111111111
111111111011000001110000000000001
100000000011000001110111111111111
100000011100000010001111111111111
10002000001111011101010010001
11002000010101011100000010001
1100N000010000001100200010001
11000000110000011010100100001
11000000010101011111011110001
11111111111101011101111010001
11111111111111111111111111111