R  640 480
NO ./texture/north.xpm
SO ./texture/south.xpm
WE ./texture/west.xpm
EA ./texture/east.xpm

S ./texture/pillar.xpm

F 255,60,60
C 200,60,70

                1111111111111111111111111
111111111111111111000000011
10110000011100000000000011
100100000000000000000000111111111
111111111011000001110000000000001
100000000011000001110111111111111
111111111100000010001111111111111
        100000000000011101010010111111111
        111111111000000000000000111111111
11111111101100000111000000000000111111
1000000000000000000000000000001110111111111111
1111111111000200000000001000111111111111111111
        100000000W00000000000000000000000101001111111111111111111111
1111111111000000000000000000010101110000001111111111
1100020000000000000000000000000000000110000010001111
11000000000000000000000110101001000111111111111111
110000000001010111110111100111111111111111
111111111111010111011110100011
1111111111111111111111111111111