R  640 480
NO ./texture/north.xpm
SO ./texture/south.xpm
WE ./texture/west.xpm
EA ./texture/east.xpm

S ./texture/health.xpm

F 255,60,60
C 200,60,10

11111111111111111111111111
10000000001100000000000011
10110000011100000000000011
100100000000000000000000111111111
111111111011000001110000000000001
100000000011000001110111111111111
100000011100000010001111111111111
1002001111011101010010001
11000000000101011100000011111
1100N000000000001100200010001
110000000000000011010100100011
112000000000101011111011110011
111111111111010111011110100011
11111111111111111111111111111