R 1920  1000
NO ./path_to_the_north_texture
SO ./path_to_the_south_texture
WE ./path_to_the_west_texture
EA ./path_to_the_east_texture

S ./path_to_the_sprite_texture
F 255,5,5,6
C 200,60,10

11111111
10000001
10000001
10000001
10000001
11111111
