R  640 480
NO ./texture/north.xpm
SO ./texture/south.xpm
WE ./texture/west.xpm
EA ./texture/east.xpm

S ./path_to_the_sprite_texture
F 255,60,60
C 200,60,10

111111111111111111111111111111111
100000000011000000000000111111111
101100000111000000000000111111111
10010000000000Z000000000111111111
111111111011000001110000000000001
100000000011000001110111111111111
11110111111111011100000010001
11110111111111011101010010001
1100000110101011100000010001
1000000000000001100000010001
1000100000000001101010010001
11000001110101011111011110001
111101111110101101111010001111
111111111111111111111111111111
