R  600  600
WE  ./texture/ice.xpm
NO  ./texture/GemOv4.xpm
S        ./texture/barrel.xpm
SO  ./texture/gold0.xpm
EA  ./texture/ice.xpm

C206,116,1
F                   255,255,255

        111111111111111111111111111
        10000000001100000000000011111111
     111111011000001110000000000001111
    11001000000000000000000001111111
11111111011000001110000000000001111
1100000000110000011101111111111110111111111
 11101111111110111000000100000000000000011
111101111111110111010100100000020000000111
11000000110101011100000011110000000000011
11111000000000000110000010000002000000111111
    111110000000000000011011000000000000001111111111111111
1111111111101011111110101000000000000000000000000200000001111111111111111
110000001101010111000000100000000000000011111111110001111111
1100000011010101110000001002000N0002000100000000111000111
1100000011010101110000001000000000001111111111111110001111
1100000011010101110000001000000000000000000000000000000001
111110011110101111111010100000020000000111111111111111111111
11000000110101011100000010000000000000001111111111000111
11000000110101011100000010020000002000100000000111000111
1100000011010101110000001000000000001111111111111110001111
1100000011010101110000001000000000000000000000000000000001
1100000111010101110000001000000210000000000000000000011111111111111111
11111111111010110111101111111111111111111111111111111111
11111111111111111111111111111
