R 1200 800
WE ./texture/west.xpm
NO ./texture/north.xpm
S ./texture/barrel.xpm
SO ./texture/north.xpm
EA ./texture/west.xpm

C 255,165,0
F 238,154,0
            11111111111111111111111111
1111111111111111100000011
1011000001110000000000001
10010000000000000000000011111111111
111111111011000001110000000000001111
10010000000000000000000011111111111
10000000001100000111011111111111111
11111111100000001000111111111111111111
        111100000000000011101010010011111111
        1111111110000000000000000111111111
1111111111110000000000000020000001111111111111
100000000000000000N0000000000000000001110111111111111
1111111111000200000000000000000001111111111111111111111111111111111
110000000001010111110111100111111111111111111
11111111111101011101111010001111
1111111111111111111111111111111