R  800 600 
WE ./texture/north.xpm
NO ./texture/east.xpm
S ./texture/barrel.xpm
SO ./texture/north.xpm
EA ./texture/north.xpm

C 0,0,194
F 63,63,63

			11111111111111111111111111
1111111111111111100000011
101100000111000000000111
10010000000000000000000011111111111
111111111011000001110000000000001111
1001000000000000000000001111111111
10000000001100000111011111111111111
11111111100000001000111111111111111111
        111100000000000011101010010011111111
        1111111110000000000000000111111111
1111111111110000000000001110020000001111111111111
100000000000000000N0000000000000000001110111111111111
1111111111000200000000000000000001111111111111111111111111111111111
110000000001010111110111100111111111111111111
11111111111101011101111010001111
1111111111111111111111111111111