R  640 480
NO ./texture/north.xpm
SO ./texture/south.xpm
WE ./texture/west.xpm
EA ./texture/east.xpm

S ./texture/pillar.xpm

F 255,60,60
C 200,60,70

11111111111111111111111111
10000000001100000000000011
10110000011100000000000011
100100000000000000000000111111111
111111111011000001110000000000001
100000000011000001110111111111111
100000011100000010001111111111111
100020000000111010100100011111
1100000000101011100000011111
1100S02002200000110000010001111
110000020000000011010100100011
1100020000010101111101111001111
111111111111010111011110100011
1111111111111111111111111111111