R  800 600 
WE ./texture/ice.xpm
NO ./texture/GemOv4.xpm
S ./texture/barrel.xpm
SO ./texture/gold0.xpm
EA ./texture/ice.xpm

C 206,116,1
F 255,255,255

			
        1111111111111111111111111
        1000000000110000000000001111
        1011000001110000000000001
        1001000000000000000000001
111111111011000001110000000000001
1100000000110000011101111111111111111111111
 1110111111111011100000010000000000000001
111101111111110111010100100000020000000111
11000000110101011100000011110000000000011
1111100000000000011000001000000200000011
    1000000000000000110110000000000000011
1111100111101011111110101000000200000001111111111111111
11000000110101011100000010000000000000001111111111000111
1100000011010101110000001002000N0002000100000000111000111
1100000011010101110000001000000000001111111111111110001111
1100000011010101110000001000000000000000000000000000000001
1100000111010101110000001000000210000000000000000000011111111111111111
11111111111010110111101111111111111111111111111111111111
11111111111111111111111111111